0 0 0 0 0 0 0 0 0 0 0 0 0 0 0 0 0 0 0 0 0 0 0 0 0 0 0 0 0 0 0 0 0 0 0 0 0 0 0 0 0 0 0 0 0 0 0 0 0 0
0 0 0 0 0 0 0 0 0 0 0 0 0 0 0 0 0 0 0 0 0 0 0 0 0 0 0 0 0 0 0 0 0 0 0 0 0 0 0 0 0 0 0 0 0 0 0 0 0 0
0 0 0 0 0 0 0 0 0 0 0 0 0 0 0 0 0 0 0 0 0 0 0 0 0 0 0 0 0 0 0 0 0 0 0 0 0 0 0 0 0 0 0 0 0 0 0 0 0 0
0 0 0 0 0 0 0 0 0 0 0 0 0 0 0 0 0 0 0 0 0 0 0 0 0 0 0 0 0 0 0 0 0 0 0 0 0 0 0 0 0 0 0 0 0 0 0 0 0 0
0 0 0 0 0 0 0 0 0 0 0 0 0 0 0 0 0 0 0 0 0 0 0 0 0 0 0 0 0 0 0 0 0 0 0 0 0 0 0 0 0 0 0 0 0 0 0 0 0 0
0 0 0 0 0 0 0 0 0 0 0 0 0 0 0 0 0 0 0 0 0 0 0 0 0 0 0 0 0 0 0 0 0 0 0 0 0 0 0 0 0 0 0 0 0 0 0 0 0 0
0 0 0 0 0 0 0 0 0 0 0 0 0 0 0 0 0 0 0 0 0 0 0 0 0 0 0 0 0 0 0 0 0 0 0 0 0 0 0 0 0 0 0 0 0 0 0 0 0 0
0 0 0 0 0 0 0 0 0 0 0 0 0 0 0 0 0 0 0 0 0 0 0 0 0 0 0 0 0 0 0 0 0 0 0 0 0 0 0 0 0 0 0 0 0 0 0 0 0 0
0 0 0 0 0 0 0 0 0 0 0 0 0 0 0 0 0 0 0 0 0 0 0 0 0 0 0 0 0 0 0 0 0 0 0 0 0 0 0 0 0 0 0 0 0 0 0 0 0 0
0 0 0 0 0 0 0 0 0 0 0 0 0 0 0 0 0 0 0 0 0 0 0 0 0 0 0 0 0 0 0 0 0 0 0 0 0 0 0 0 0 0 0 0 0 0 0 0 0 0
0 0 0 0 0 0 0 0 0 0 0 0 0 0 0 0 0 0 0 0 0 0 0 0 0 0 0 0 0 0 0 0 0 0 0 0 0 0 0 0 0 0 0 0 0 0 0 0 0 0
0 0 0 0 0 0 0 0 0 0 0 0 0 0 0 0 0 0 0 0 0 0 0 0 0 0 0 0 0 0 0 0 0 0 0 0 0 0 0 0 0 0 0 0 0 0 0 0 0 0
0 0 0 0 0 0 0 0 0 0 0 0 0 0 0 0 0 0 0 0 0 0 0 0 0 0 0 0 0 0 0 0 0 0 0 0 0 0 0 0 0 0 0 0 0 0 0 0 0 0
0 0 0 0 0 0 0 0 0 0 0 0 0 0 0 0 0 0 0 0 0 0 0 0 0 0 0 0 0 0 0 0 0 0 0 0 0 0 0 0 0 0 0 0 0 0 0 0 0 0
0 0 0 0 0 0 0 0 0 0 0 0 0 0 0 0 0 0 9 9 9 0 8 2 2 2 9 0 0 0 0 0 0 0 0 0 0 0 0 0 0 0 0 0 0 0 0 0 0 0
0 0 0 0 0 0 0 0 0 0 0 0 0 0 0 0 0 0 3 10 4 0 3 10 10 10 3 0 0 0 0 0 0 0 0 0 0 0 0 0 0 0 0 0 0 0 0 0 0 0
0 0 0 0 0 0 0 0 0 0 0 0 0 0 0 0 0 0 3 10 4 0 3 10 4 10 3 0 0 0 0 0 0 0 0 0 0 0 0 0 0 9 9 9 0 0 0 0 0 0
0 0 0 0 0 0 0 0 0 0 0 0 0 0 0 9 2 2 3 10 4 0 3 10 4 10 3 0 0 0 0 0 0 0 0 0 0 0 0 0 0 9 11 9 0 0 0 0 0 0
0 0 0 0 0 0 0 0 0 0 0 0 0 0 0 3 10 10 10 10 4 0 3 10 4 10 3 0 0 0 0 0 0 0 0 0 0 0 0 0 0 9 10 9 0 0 0 0 0 0
0 0 0 0 0 0 0 0 0 0 0 0 0 0 0 3 10 0 0 10 6 9 5 10 4 10 3 0 0 0 0 0 0 0 0 0 0 0 0 9 9 9 10 9 9 9 9 0 0 0
0 0 0 0 0 0 0 0 0 0 0 0 0 0 0 3 10 9 9 10 10 10 10 10 4 10 9 9 0 0 0 0 0 0 0 0 0 0 0 9 10 10 10 10 10 10 9 0 0 0
0 0 0 0 0 0 0 0 0 0 0 0 0 0 0 3 10 10 10 10 10 10 10 9 4 10 10 2 2 2 2 2 7 0 0 0 0 0 0 9 10 0 10 9 0 10 9 0 0 0
0 0 0 0 0 0 0 0 0 0 0 0 0 0 0 9 2 2 2 7 8 1 1 1 9 3 10 10 10 10 10 10 3 0 0 0 0 0 0 9 10 0 10 0 0 10 9 0 0 0
0 0 0 0 0 0 0 0 0 0 0 0 9 1 1 1 1 1 1 3 4 10 10 10 10 10 10 10 10 10 10 10 3 0 0 0 0 0 0 9 10 9 10 10 10 10 9 0 0 0
0 0 0 0 0 0 0 0 0 0 0 0 4 10 10 10 10 10 10 3 4 10 0 0 0 0 10 10 0 0 0 10 3 0 0 0 0 0 0 9 10 9 9 9 9 9 9 0 0 0
0 0 0 0 0 0 0 0 0 0 0 0 4 10 0 0 10 0 10 3 4 10 0 0 0 0 10 10 0 9 0 10 13 0 0 0 0 0 0 9 10 9 0 0 0 0 0 0 0 0
0 0 0 0 0 0 0 0 0 0 0 0 4 10 0 0 10 0 10 9 9 10 10 10 10 10 10 10 10 10 0 10 13 0 0 0 0 0 0 9 10 9 0 0 0 0 0 0 0 0
0 0 0 0 0 0 0 0 0 0 0 0 12 10 0 9 10 10 10 10 10 10 10 10 10 10 10 10 9 10 10 10 13 0 0 0 0 0 0 9 10 9 0 0 0 0 0 0 0 0
0 0 0 0 0 0 0 0 0 0 0 0 12 10 10 10 10 9 2 2 2 2 2 2 2 2 2 2 2 10 9 2 9 0 0 9 1 1 1 9 10 9 0 0 0 0 0 0 0 0
0 0 0 0 0 0 0 0 0 0 0 0 6 1 1 1 2 2 0 0 0 0 0 0 0 0 0 0 4 10 3 0 0 0 0 4 10 10 10 10 10 9 2 2 2 2 9 0 0 0
0 0 0 0 0 0 0 0 0 0 0 0 0 0 0 0 8 1 1 1 1 1 1 1 7 0 0 0 4 10 3 0 0 0 0 4 10 10 10 10 10 10 10 10 10 10 9 0 0 0
0 0 0 0 0 0 0 0 0 0 0 0 0 0 0 0 4 10 10 10 10 10 10 10 3 0 0 0 4 10 3 0 0 0 0 4 10 0 0 0 9 0 0 0 0 10 13 0 0 0
0 0 0 0 0 0 0 0 0 0 0 0 0 0 0 0 4 10 8 2 2 2 7 10 3 0 0 0 4 10 3 0 0 0 0 4 10 10 10 10 10 0 0 0 0 10 13 0 0 0
0 0 0 0 0 0 0 0 0 0 0 0 0 0 0 0 4 10 3 0 0 0 4 10 6 1 1 1 1 10 3 0 0 0 0 4 10 0 0 0 10 0 0 0 0 10 13 0 0 0
0 0 0 0 0 0 0 0 0 0 0 0 0 0 0 0 4 10 3 0 0 0 4 10 10 10 10 10 10 10 3 0 0 0 0 4 10 10 10 10 10 10 10 10 10 10 13 0 0 0
0 0 0 0 0 0 0 0 0 0 0 0 0 0 0 0 4 10 3 0 0 0 6 2 2 2 2 2 2 2 2 0 0 0 0 4 10 10 10 10 10 4 2 2 2 2 9 0 0 0
0 0 0 0 0 0 0 0 0 0 0 0 0 0 0 0 4 10 3 0 0 0 0 0 0 0 0 0 0 0 0 0 0 0 0 9 2 2 2 7 10 4 0 0 0 0 0 0 0 0
0 0 0 0 0 0 0 0 0 0 0 0 8 1 1 1 5 10 6 1 1 1 1 1 1 1 1 1 0 0 1 1 1 1 1 1 1 1 1 5 10 4 0 0 0 0 0 0 0 0
0 0 0 0 0 0 0 0 0 0 0 0 4 10 10 10 10 10 10 10 10 10 10 10 10 10 10 4 1 1 3 10 10 10 10 10 10 10 10 10 10 4 0 0 0 0 0 0 0 0
0 0 0 0 0 0 0 0 0 0 0 0 4 10 0 10 0 10 8 2 2 2 2 2 3 10 10 10 10 10 10 10 10 10 10 10 10 3 2 2 2 2 0 0 0 0 0 0 0 0
0 0 0 0 0 0 0 0 0 0 0 0 4 10 0 10 0 10 3 0 0 0 0 0 6 2 2 2 2 2 2 3 0 0 0 0 10 3 0 0 0 0 0 0 0 0 0 0 0 0
0 0 0 0 0 0 0 0 0 0 0 0 4 10 10 10 10 10 3 0 0 0 0 0 0 0 8 1 1 1 1 3 0 0 0 0 10 3 0 0 0 0 0 0 0 0 0 0 0 0
0 0 0 0 0 0 0 0 0 0 0 0 6 2 7 10 9 10 3 0 0 0 0 0 0 0 4 10 10 10 10 10 10 10 10 10 10 3 0 0 0 0 0 0 0 0 0 0 0 0
0 0 0 0 0 0 0 0 0 0 0 0 0 0 2 10 9 10 9 2 2 9 0 0 0 0 4 10 0 0 0 0 0 0 0 0 10 3 0 0 0 0 0 0 0 0 0 0 0 0
0 0 0 0 0 0 0 0 0 0 0 0 0 0 3 10 10 10 10 10 10 3 0 0 0 0 4 10 0 0 0 0 0 0 0 0 10 3 0 0 0 0 0 0 0 0 0 0 0 0
0 0 0 0 0 0 0 0 0 0 0 0 0 0 3 10 0 10 0 0 10 3 0 0 0 0 4 10 0 0 0 0 0 0 0 0 10 3 0 0 0 0 0 0 0 0 0 0 0 0
0 0 0 0 0 0 0 0 0 0 0 0 0 0 12 10 0 10 0 0 10 3 0 0 0 0 4 10 10 10 10 10 10 10 10 10 10 3 0 0 0 0 0 0 0 0 0 0 0 0
0 0 0 0 0 0 0 0 0 0 0 0 0 0 12 10 0 10 0 0 10 3 0 0 0 0 6 2 2 2 2 2 2 2 2 2 2 5 0 0 0 0 0 0 0 0 0 0 0 0
0 0 0 0 0 0 0 0 0 0 0 0 0 0 12 10 10 10 10 10 10 3 0 0 0 0 0 0 0 0 0 0 0 0 0 0 0 0 0 0 0 0 0 0 0 0 0 0 0 0
0 0 0 0 0 0 0 0 0 0 0 0 0 0 6 2 2 2 2 2 2 5 0 0 0 0 0 0 0 0 0 0 0 0 0 0 0 0 0 0 0 0 0 0 0 0 0 0 0 0